also remove image=verwijder ook het image
Apply=Toepassen
Are you sure=Weet u het zeker?
Cancel=Annuleren
checking=controleren
Completely REMOVE=Geheel VERWIJDEREN
Console=Console
day=dag
days=dagen
disk image and definition=schijfimage en definitie
Disks=Schijven
Donate=Doneren
Done=Klaar
Edit=Bewerken
Execution error=Uitvoeringsfout
Force Stop=Gedwongen Stop
Hibernate=Winterslaap
Log for=Log voor:
log=log
Logs=Logboek
More Info=Meer Info
No=Nee
OK=OKÉ
Ok=Oké
Pause=Pauzeren
Proceed=Doorgaan
Project Page=Projectpagina
Read Me First=Lees mij eerst
Remove container=Container verwijderen
Remove definition=Verwijder definitie:
Remove image=Image verwijderen
Remove VM=Verwijder VM
Remove=Verwijderen
Restart=Herstarten
Resume=Hervatten
Start=Starten
Stop=Stoppen
Support=Ondersteuning
Update container=Container bijwerken
Update=Bijwerken
Updating all Containers=Bezig met alle containers bijwerken
Updating the container=Bezig met bijwerken van container
VNC Remote=VNC Toegang
WebUI=Venster
Yes, delete it=Ja, verwijderen
Yes, update it=Ja, bijwerken
Yes=Ja

; footer messages
Array Copying=Array kopiëren
Array Clearing=Array leegmaken
Array Starting=Array wordt gestart
Array Stopping=Array wordt gestopt
Mounting disks=Schijven koppelen
Retry unmounting user shares=Retry unmounting user share(s)
Spinning up all drives=Alle schijven opstarten
Stale configuration=
Starting services=Diensten starten
Stopping services=Diensten stoppen
Starting Recycle Bin=
Stopping Recycle Bin=
Sync filesystems=
Unmounting disks=Schijven ontkoppelen
Autostart disabled=Autostart uitgeschakeld
Missing encryption key=Ontbrekende encryptie-sleutel
Opening encrypted volumes=Versleutelde volumes openen

; docker variables
Container Path=Container Pad
Container Port=Container Poort
Container Variable=Container Variabele
Container Label=Container Label
Container Device=Container apparaat

; Note: June 6, 2022 - 5 missing translations
