12 hours=12 uur
24 hours=24 uur
8023ad=802.3ad
Active Directory Settings=Active Directory Instellingen
Active Directory=Active Directory
active-backup=actief-reserve
AD account login=AD account login
AD account password=AD account wachtwoord
AD domain name=AD domeinnaam
AD initial group=AD initiële groep
AD initial owner=AD initiële eigenaar
AD join status=AD toetreden status
AD short domain name=AD verkorte domeinnaam
Add Route=Route toevoegen
Add VLAN=VLAN aanmaken
Agent function=Agentfunctie
Agents=Agenten
Alerts=Alerts
and, the first and last characters must be alphanumeric=en, de eerste en laatste karakters moeten leesbaar zijn
and=en
APC UPS Daemon user manual=APC UPS-daemon gebruikershandleiding
APCsmart=APCslim
Apply to activate VMs after Array is Started=Toepassen om VMs te activeren nadat de array is gestart
Array must be Stopped to change=De array moet worden **Gestopt** om te kunnen veranderen
Array status notification=Array statusmelding
Array status=Array status
Assignment error=Toewijzingsfout
Attention=Attentie
Attribute=Attribuut
Authentication method=Authenticatie methode
Available notifications=Beschikbare meldingen
balance-alb=balanceer-alb
balance-rr=balanceer-rr
balance-tlb=balanceer-tlb
balance-xor=balanceer-xor
Bar color - Text=Balk (kleur) - Tekst
Bar color=Balk (kleur)
Bar gray - Text=Balk (grijs) - Tekst
Bar gray=Balk (grijs)
Battery Charge=Acculading
Battery level to initiate shutdown=Accuniveau om Uitschakelen van het systeem te starten
bfq=bfq
Bonding members of=Bondig leden van
Bonding mode=Bonding-modus
Both=Beiden
bottom-left=linksbeneden
bottom-right=rechtsbeneden
Bridging members of=Bridging leden van
broadcast=boradcast
Browser=Browser
btrfs filesystem show=btrfs bestandsysteem info
btrfs scrub status=btrfs bestandsysteem status
Cache disk not enabled=Groep opslag is niet ingeschakeld
Cache Settings=Groeplinstellingen
Cannot provision cert that would overwrite your existing custom cert at=Kan geen certificaat installeren welke het huidige aangepaste certificaat overschrijft op
Cannot renew cert until within 30 days of expiry=Kan geen certificaat hernieuwen totdat de 30 dagen zijn verstreken
center=in het midden
Certificate expiration=Certificaat vervaltijd
Certificate issuer=Certificaat uitgever
Check cable=Controleer de kabel
Check four times a day=Controleer vier keer per dag
Check once a day=Controleer één keer per dag
Check once a month=Controleer één keer per maand
Check once a week=Controleer één keer per week
Check twice a day=Controleer twee keer per dag
Click here to see the Unraid Wiki for more information=Druk hier voor meer informatie op de Unraid Wiki
Click to invoke the Mover=Indrukken om de Mover te starten
Click to select PNG file=Druk hier om een PNG bestand te selecteren
Click to Select=Druk op Select
configuring interface=koppelvlak configureren
Confirm array stop command=Bevestig array Stoppen commando
Confirm reboot powerdown commands=Bevestig systeem Herstarten & Uitzetten commando's
Confirm sleep command=Bevestig Slapen commando
Confirmations=Bevestigingen
Container=Container
Content=Inhoud
Correct file system errors=Corrigeer bestandssysteemfouten
CPU Isolation A reboot is required to apply changes=CPU isolatie: Een herstart is nodig om de veranderingen actief te maken
CPU isolation is prohibited while system is running in SAFE MODE=CPU isolatie is verboden wanneer het systeem in de veiligheismodus draait
CPU Isolation=CPU Isolatie
CPU Pinning Docker=CPU Klemming Docker
CPU Pinning VM=CPU Klemming VM
CPU Pinning=CPU Klemming
Current date and time=Huidige datum en tijd
Custom attributes use comma to separate numbers=Aangepaste attributen (gebruik komma om getallen te scheiden)
Custom banner=Aangepaste banner
Custom UPS cable=Aangepaste UPS kabel
Custom=Aangepast
custom=aangepast
D comma G dot=[P] komma : [G] punt
D comma G none=[P] komma : [G] leeg
D comma G space=[P] komma : [G] spatie
D dot G comma=[P] punt : [G] komma
D dot G none=[P] punt : [G] leeg
D dot G space=[P] punt : [G] spatie
Daily=Elke dag
Date and Time=Datum en Tijd
Date format=Datumformaat
Day of the month=Dag van de maand
Day of the week=Dag van de week
Day, D Month YYYY=Dag, D Maand JJJJ
Day, DD.MM.YYYY=Dag, DD.MM.JJJJ
Day, DD-MM-YYYY=Dag, DD-MM-JJJJ
Day, MMDDYYYY=Dag, MM/DD/JJJJ
Day, Month D, YYYY=Dag, Maand D, JJJJ
Day, YYYY Month D=Dag, JJJJ Maand D
Day, YYYY-MM-DD=Dag, JJJJ-MM-DD
DD-MM-YYYY=DD-MM-JJJJ
Default appdata storage location=Standaard appdata locatie
Default critical disk temperature threshold=Standaard schijftemperatuur alertniveau
Default critical disk utilization threshold=Standaard schijfgebruik alertniveau
Default file system=Standaard bestandsysteem
Default ISO storage path=Standaard ISO opslagpad
Default network bridge=Standaard netwerkbrug
Default partition format=Standaard partitie formaat
Default SMART attribute notifications=Standaard SMART attributen meldingen
Default SMART controller type=Standaard SMART controller type
Default SMART notification tolerance level=Standaard SMART meldingstolerantie
Default SMART notification value=Standaard SMART meldingswaarde
Default spin down delay=Standaard schijf-uitzetten tijd
Default VM storage path=Standaard VM opslagpad
Default warning disk temperature threshold=Standaard schijftemperatuur alarmniveau
Default warning disk utilization threshold=Standaard schijfgebruik alarmniveau
Default Windows VirtIO driver ISO=Standaard Windows VirtIO ISO stuurprogramma
Define a TLS certificate=Definieer een TLS certificaat
Delete Image File=Verwijder Image bestand
Delete VLAN=VLAN verwijderen
Desired MTU=Gewenste MTU
Detailed=Volledig
Device=Apparaat
DHCP pool=DHCP groep
Disk Settings=Schijfinstellingen
Display array totals=Array totalen tonen
Display device name=Opslagnaam tonen
Display position=Positie van meldingen
Display Settings=Beeldinstellingen
Display world-wide-name in device ID=World-wide-name in opslagnaam tonen
Docker LOG maximum file size=Docker LOG maximale bestandsgrootte
Docker LOG number of files=Docker LOG aantal bestanden
Docker LOG rotation=Docker LOG rotatie
Docker only=Enkel Docker
Docker service=Docker dienst
Docker update notification=Docker update melding
Docker update=Docker update
Docker vDisk location=Docker v-Schijf locatie
Docker vDisk size=Docker v-Schijf grootte
Docker version=Docker versie
Docker volume info=Docker volume info
Docker=Docker
Download Windows VirtIO driver ISO=Download Windows VirtIO ISO stuurprogramma
Downstream=Downstream
Drag-n-drop a PNG file or click the image at the left=Sleep en zet een PNG bestand neer of druk op de banner links
Dumb=Dom
Dynamix color theme=Dynamix kleurenschema
Email recipients=Email ontvangers
Email subject prefix=Email onderwerpvoorvoegsel
Email=Email
Enable auto start=Gebruik auto start
Enable bonding=Gebruik bonding
Enable bridging=Gebruik bridging
Enable disk shares=Gebruik schijfmappen
Enable Docker=Gebruik Docker
Enable NetBIOS=Gebruik NetBIOS
Enable NFS=Gebruik NFS
Enable SMB=Gebruik SMB
Enable spinup groups=Gebruik schijf aanzetgroepen
Enable user shares=Gebruik gebruikersmappen
Enable VLANs=Gebruik VLANs
Enable VMs=Gebruik VMs
Enable WSD=Gebruik WSD
Enhanced macOS interoperability=Verbeterde macOS ondersteuning
Enter route + gateway + metric=Invoeren route + router + metriek
Ether=Ethernet
Ethernet Port=Ethernet poort
Event=Voorval
Every day=Alle dagen
Every month=Alle maanden
Every week=Alle weken
exceeds Disk Shutdown=overschrijft Schijf afsluiten
Excluded disks=Uitgesloten schijven
Execution error=Verwerkingsfout
Failed to stop=Mislukt om te stoppen
Failure to do so may result in your docker image suffering corruption at a later time=Wanneer dit niet wordt gedaan dan bestaat de kans dat er later corruptie optreedt
First day=Eerste dag
First week=Eerste week
Font size=Lettergrootte
Fourth week=Vierde week
FTP server=FTP server
FTP users=FTP gebruiker(s)
Gateway=Router
gateway name or address=routernaam of adres
Global Share Settings=Algemene Mapinstellingen
Global SMART Settings=Algemene SMART Instellingen
has been created on unraidnet=is aangemaakt op unraid.net
has been updated for unraidnet=is bijgewerkt voor unraid.net
Header custom background color=Achtergrondkleur van hoofdbalk
Header custom text color=Tekstkleur van hoofdbalk
Header menu=Hoofdmenu
HHMM=UU:MM
Hibernate VMs=VMs slaapstand
Hide dot files="Punt" bestanden verbergen
Host access to custom networks=Host toegang tot aangepaste netwerken
hosts=hosts
Hourly=Elk uur
HTML color code of 3 or 6 hexadecimal digits=HTML kleurcode van 3 of 6 hexadecimale cijfers
HTTP port=HTTP poort
HTTPS port=HTTPS poort
Huge=Enorm groot
Identification=Identificatie
Importance=Belang
Included disks=Aangesloten schijven
Interface description=Koppelvlak beschrijving
Interface Rules=Koppelvlakregels
Invalid email address=Ongelidg emailadres
Invalid IPv4 gateway=Ongeldig IPv4 router
Invalid IPv4 range=Ongeldig IPv4 bereik
Invalid IPv4 subnet=Ongeldig IPv4 subnet
Invalid IPv6 gateway=Ongeldig IPv6 router
Invalid IPv6 range=Ongeldig IPv6 bereik
Invalid IPv6 subnet=Ongeldig IPv6 subnet
Invalid pool address=Ongeldig groep adres
Invalid subnet size=Ongeldige subnet grootte
IPv4nn or IPv6nn route=IPv4/nn of IPv6/nn route
IPv4 address A.B.C.D=IPv4 adres A.B.C.D
IPv4 address assignment=IPv4 adres toekenning
IPv4 address=IPv4 adres
IPv4 custom network on interface=IPv4 aangepast netwerk op koppelvlak
IPv4 default gateway=IPv4 router
IPv4 DNS server assignment=IPv4 DNS server toekenning
IPv4 DNS server=IPv4 DNS server
IPv4 IPv6=IPv4 en IPv6
IPv4 only=alleen IPv4
IPv6 address assignment=IPv6 adres toekenning
IPv6 address nnnnxxxxyyyy=IPv6 adres nnnn:xxxx::yyyy
IPv6 address=IPv6 adres
IPv6 custom network on interface=IPv6 aangepast netwerk op koppelvlak
IPv6 default gateway=IPv6 router
IPv6 DNS server assignment=IPv6 DNS server toekenning
IPv6 DNS server=IPv6 DNS server
IPv6 only=alleen IPv6
IPv6 privacy extensions=IPv6 privacy-extensies
is down=is uit
Isolated CPUs=Geïsoleerde CPUs
Isolation=Isolatie
Key=Sleutel
kyber=kyber
Language=Taalkeuze
Language update=Taal update
Language update notification=Taal update melding
Large=Groot
Last day=Laatste dag
Last week=Laatste week
LE Cert Provisioned successfully=LE Certificaat succesvol aangemaakt
Libvirt Log=Libvirt Log
Libvirt storage location=Libvirt opslaglocatie
Libvirt version=Libvirt versie
Libvirt volume info=Libvirt volume informatie
License key required=Licentie sleutel nodig
List of VLANs contains duplicate VLAN numbers=Lijst van VLANs heeft duplicaten VLAN nummers
Listing height=Lijsthoogte
Local master=Lokale meester
Local syslog folder=Lokale syslog map
Local syslog maximum file size=Lokale syslog maximale bestandsgrootte
Local syslog number of files=Lokale syslog aantal bestanden
Local syslog rotation=Lokale syslog rotatie
Local syslog server=Lokale syslog server
Local TLD=Lokale TLS
Lost communication=Verbinding verbroken
MAC address=MAC adres
Mail server port=Mail server poort
Mail server=Mail server
Management Access=Toegang
Manual=Handmatig
may conflict with well-known services=kan conflicteren met bekende diensten
member of=lid van
Metric=Metriek
Mirror syslog to flash=Dupliceer syslog naar flash
Missing subnet size=Ontbrekende subnet grootte
MM-DD-YYYY=MM-DD-JJJJ
ModBus=ModBus
Modify with caution unable to validate path until Array is Started=Wijzig voorzichtig: niet mogelijk om het pad te valideren totdat de array is gestart
Month of the year=Maand van het jaar
Monthly=Elke maand
Move now=Nu verplaatsen
Mover logging=Mover logging
Mover Settings=Mover Instellingen
Mover schedule=Mover planning
mq-deadline=mq-deadline
Multi-function=Multi-functioneel
must be a file directory provided=moet een bestand zijn; map meegegeven
Net=Netwerk
Network protocol=Netwerkprotocol
Network Services=Netwerkdiensten
Network Settings=Netwerkinstellingen
Never check=Nooit controleren
Never send=Nooit versturen
New date and time=Nieuwe datum en tijd
NFS=NFS
No battery detected=Geen accu gedetecteerd
No Cache disk present=Geen groepschijf aanwezig
No CPU pinning available. Docker service must be started=Geen CPU klemming beschikbaar. Docker dienst moet worden gestart
No CPU pinning available. VM service must be started=Geen CPU klemming beschikbaar. VM dienst moet worden gestart
No Parity disk present=Geen pariteitschijf aanwezig
Nominal Power=Nominaalvermogen
Non-recommended port=Geen aanbevolen poort
Non-tabbed=Onder elkaar
Not allowed to assign ZERO cores=Niet toegestaan om NUL cores toe te kennen
Not compatible with NetBIOS=Niet verenigbaar met NetBIOS
not configured=niet geconfigureerd
not set=niet gezet
Nothing to do=Niks te doen
Notices=Berichten
Notification Agents=Meldingsagenten
Notification entity=Meldingen entiteit
Notification Settings=Meldingsinstellingen
Notifications display=Meldingen tonen
NTP server=NTP server
Number format=Nummerformaat
Number scaling=Nummerschaling
Obtaining DNSv4 server=DNSv4 server opvragen
Obtaining DNSv6 server=DNSv6 server opvragen
Obtaining IPv4 address=IPv4 adres opvragen
Obtaining IPv4 gateway=IPv4 router opvragen
Obtaining IPv6 address=IPv6 adres opvragen
Obtaining IPv6 gateway=IPv6 router opvragen
obtaining=verkrijgen
On battery=Op accu
One or more paths do not exist=Eén of meerdere paden bestaan niet
Online boost=Online (versterken)
Online trim=Online (verzwakken)
Online=Online
Only alphanumeric characters=Enkel leesbare karakters
Only PNG images are allowed=Enkel PNG bestanden zijn toegestaan
Oops=Oeps
optional metric lowest is preferred=optionele metriek (laagste waarde heeft voorkeur)
optional metric lowest is preferred, 0 is no default gateway=optionele metriek (laagste waarde heeft voorkeur, 0 is geen router)
Page view=Pagina opbouw
Parity Check=Pariteitscontrole
Password=Wachtwoord
Path does not exist=Pad bestaat niet
PCIe ACS override=PCIe ACS overname
PCnet=PCnet
Placement of Users menu=Plaatsing van Gebruikersmenu
Please disable the VM function=Schakel de VM functie uit
Please do this NOW=Doe dit NU
Please enter a valid gateway=Voer een geldige router in
Please enter a valid range=Voer een geldig IPv4 bereik in
Please enter a valid sending email address=Geef een geldig verzend emailadres op
Please enter a valid subnet=Voer een geldig subnet in
Plugins update notification=Plug-ins update melding
Plugins update=Plug-ins update
Pool address is out of range=Groep adres is buiten bereik
Pool subnet size is not defined=Groep subnet grootte niet opgegeven
Pool subnet size is too large=Groep subnet grootte is te groot
Port Down=Poort Af
Port Up=Poort Op
Preserve user defined networks=Behoudt gebruikers netwerken
Preset service=Voorkeuze dienst
Priority in header=Prioriteit in kop
Protocol=Protocol
Provision=Voorzien
readmodifywrite=lezen/aanpassen/schrijven
reconstruct write=herbouwend schrijven
Refreshing=Verversen
Registration key required=Registratie sleutel nodig
Remote syslog server=Externe syslog server
Remove Windows VirtIO driver ISO=Verwijder Windows VirtIO ISO stuurprogramma
resolution=oplossing
Route=Route
Routing Table=Route-tabel
Rules=Regels
Runtime left to initiate shutdown=Resterende looptijd om een Systeem Uitschakelen te starten
Runtime Left=Overgebleven looptijd
Samba extra configuration=Samba extra configuratie
Scheduled parity check=Geplande pariteitscontrole
Scheduler=Planner
Scrub=Boenen
Second week=Tweede week
See Help for more details and workarounds=Zie Hulp voor meer details en tijdelijke oplossingen
see interface=zie koppelvlak
Send every hour=Verstuur elk uur
Send every two hours=Verstuur elke twee uur
Send four times a day=Verstuur vier keer per dag
Send once a day=Verstuur één keer per dag
Send once a month=Verstuur één keer per maand
Send once a week=Verstuur één keer per week
Send three times a day=Verstuur drie keer per dag
Send twice a day=Verstuur twee keer per dag
Sending email address=Verzend emailadres
Server name=Servernaam
Server was unable to provision SSL certificate=Server was niet in staat om het SSL certificaat te voorzien
Setting disabled in safe mode=Instelling is uitgeschakeld in **veilige modus**
Settings menu=Instellingenmenu
Show array utilization indicator=Array gebruiksindicator tonen
Show banner=Banner tonen
Show Dashboard apps=Paneeltoepassingen tonen
Shutdown time-out=Wachttijd voor Uitschakelen van het systeem
Shutdown VMs=VMs afsluiten
Simple=Simpel
Small=Klein
Smart=Slim
SMB Extras=SMB Extras
SMB Settings=SMB Instellingen
SMB=SMB
SMTP Settings=SMTP Instellingen
SNMP=SNMP
Sorry, an error occurred in processing your SSL certificate=Sorry, een fout is opgetreden bij het verwerken van het SSL certificaat
Sorry, an error occurred updating unraidnet DNS records=Sorry, een fout is opgetreden bij het bijwerken van de unraid.net DNS boeking
SSH port=SSH poort
Start APC UPS daemon=Start APC UPS-daemon
Start page=Start pagina
Static=Statisch
Stop %s to make changes, see=Stop **%s** om veranderingen te maken, zie
Store notifications to flash=Meldingen opslaan op Flash
Subject=Onderwerp
Subnet=Subnet
success=gelukt
Summarized=Beknopt
Syslog Server=Syslog Server
System notifications=Systeemmeldingen
System Setting=Systeeminstelling
System Settings=Systeeminstellingen
Tabbed=Naast elkaar
TELNET port=TELNET poort
Temperature unit=Temperatuureenheid
Template Authoring Mode=Sjabloon authoring modus
Test running=Lopende test
Text - Bar color=Tekst - Balk (kleur)
Text - Bar gray=Tekst - Balk (grijs)
Text=Tekst
Third week=Derde week
This is required to create VMs in KVM=Dit is nodig om VMs aan te maken in KVM
this mode requires a network switch with proper setup and support=deze modus vergt een netwerk switch met de juiste ondersteuning
Time format=Tijdformaat
Time of the day=Tijd van de dag
Time on battery before shutdown=Accutijd voordat systeem wordt uitgeschakeld
Time zone=Tijdzone
time-out=pauze
Timestamp=Tijdstempel
TLS certificate location=TLS certificaat locatie
Toggle thread to containers=Schakel tussen containers
top-left=linksboven
top-right=rechtsboven
Tunable enable Direct IO=Afstemmen (gebruik Direct IO)
Tunable enable NCQ=Afstemmen (NCQ)
Tunable fuse_remember=Afstemmen (fuse_remember)
Tunable md_num_stripes=Afstemmen (md_num_stripes)
Tunable md_queue_limit=Afstemmen (md_queue_limit)
Tunable md_sync_limit=Afstemmen (md_sync_limit)
Tunable md_write_method=Afstemmen (md_write_method)
Tunable nr_requests=Afstemmen (nr_requests)
Tunable poll_attributes=Afstemmen (poll_attributes)
Tunable scheduler=Afstemmen (scheduler)
Tunable support Hard Links=Afstemmen (ondersteun Hard Links)
Turn off UPS after shutdown=Schakel UPS uit nadat het systeem is uitgeschakeld
; Keep the original plugin name in settings
Unassigned Devices=Unassigned Devices
Unraid OS update notification=Unraid OS update melding
Unraid OS update=Unraid OS update
Update DNS=DNS bijwerken
updating=bijwerken
Upon host shutdown=Bij afsluiten van de host
UPS cable=UPS kabel
UPS Details=UPS Details
UPS Load=UPS lading
UPS Settings=UPS Instellingen
UPS Status=UPS status
UPS type=UPS type
USB=USB
Use cache device=Gebruik groep opslag
Use NTP=Gebruik NTP
Use SSH=Gebruik SSH
Use SSLTLS=Gebruik SSL/TLS
Use STARTTLS=Gebruik STARTTLS
Use TELNET=Gebruik TELNET
Use UPnP=Gebruik UPnP
Used Free columns=Gebruikt/Beschikbaar kolommen
User Preferences=Gebruikersvoorkeuren
User shares not enabled=Gebuikersmappen zijn niet ingeschakeld
User Utilities=Gereedschapskist
Username=Gebruikersnaam
user-set=aangepast
value must be a number=invoer moet een getal zijn
Value=Waarde
Very large=Heel groot
Very small=Heel klein
VFIO allow unsafe interrupts=VFIO onveilige interrupts toestaan
View libvirt log=Bekijk libvirt log
view=tonen
VLAN assignment mismatch=VLAN toekenningsfout
VLAN number=VLAN nummer
VM Manager=VM Manager
VM shutdown time-out=VM afsluitpauze
VM=VM
VMs only=Enkel VMs
VMs will be available after Array is Started=VMs komen beschikbaar nadat de array is gestart
VPN Manager=VPN Manager
Warnings=Waarschuwingen
Watts=Wattage
Week of the month=Week van de maand
Weekly=Elke week
Workgroup Settings=Werkgroep Instellingen
Workgroup=Werkgroep
Write corrections to parity disk=Schrijf correcties naar de pariteitschijf
WSD options experimental=WSD opties [experimenteel]
Yearly=Elk jaar
Your existing Docker image file needs to be recreated due to an issue from an earlier beta of Unraid 6=De bestaande docker image moet opnieuw worden gemaakt door een probleem uit een eerdere beta versie van Unraid 6
Your hardware does not have Intel VT-x or AMD-V capability=De hardware heeft geen Intel VT-x of AMD-V mogelijkheden
Your Lets Encrypt SSL Certificate has been provisioned and a DNS record for local IP address=Het Let's Encrypt SSL certificaat is voorzien en een DNS boeking voor het lokale IP adres
Your Lets Encrypt SSL Certificate has been renewed=Het Let's Encrypt SSL certificaat is hernieuwd
Your local IP address=Het lokale IP adres
Your router or DNS server has DNS rebinding protection enabled, preventing=De router of DNS server heeft 'DNS rebinding' bescherming aanstaan
YYYY-MM-DD=JJJJ-MM-DD

; New entries (172) - 2021-03-14
Activate=Activeren
Activated=Geactiveerd
Activating=Activeren
Add Peer=Peer toevoegen
Add Tunnel=Tunnel toevoegen
Advanced=Geavanceerd
Allow Remote Access=Externe toegang toestaan
Allow=Toestaan
Apply to activate Docker after Array is Started=Pas toe om Docker te activeren nadat de Array is gestart
Applying=Toepassen
Are you sure you want pause communication with your remote flash backup on unraidnet=Weet u zeker dat u de communicatie met uw externe flashback-up op unraid.net wilt onderbreken?
Are you sure you want to erase all change history in both local and unraidnet remote=Weet u zeker dat u alle wijzigingsgeschiedenis in zowel de lokale als de externe unraid.net wilt wissen?
automatic=automatisch
Autostart=Auto-start
Basic=Eenvoudig
btrfs vDisk=btrfs vDisk
Celsius=Celsius
Changes=Veranderingen
Checking=Controleren
CIDR optional=CIDR optioneel
Comma separated list of IPv4 and IPv6 IP addresses=Comma gescheiden lijst van IPv4 en IPv6 adressen
configure your router with a static route of=configureer de router met een statische route van
configure your router with port forwarding of port=configureer de router met port-forwarding van poort
connect to any device on the VPN tunnel=maak verbinding met elk apparaat in de VPN-tunnel 
connect to this server using IP address=maak verbinding met deze server met behulp van het IP-adres
CRAM-MD5=CRAM-MD5
Data received=Data ontvangen
Data sent=Data verzonden
Deactivate=Deactiveren
Deactivating=Deactiveren
Delete directory=Directory verwijderen
Delete Peer=Peer verwijderen
Delete Tunnel=Tunnel verwijderen
Delete vDisk file=vDisk-bestand verwijderen
Deny=Weigeren
directory=directory
Disabled until you Provision an unraidnet SSL Cert and set SSL-TLS to Auto=Uitgeschakeld totdat u een unraid.net SSL-certificaat levert en SSL-TLS instelt op Auto
Disabled until your root user account is password-protected=Uitgeschakeld totdat uw rootgebruikersaccount met een wachtwoord is beveiligd
docker containers on custom networks need static routing=docker containers op aangepaste netwerken hebben statische routering nodig
Docker data-root=Docker data-root
Docker directory=Docker directory
Docker Stop Timeout=Time-out voor Docker-stop
Docker VMs=Docker + VMs
Docker will be available after Array is Started=Docker is beschikbaar nadat de Array is gestart
Downloading=Downloaden
enable advanced settings view=schakel geavanceerde instellingen in
encrypted=versleuteld
ensure the peer network is different from=zorg ervoor dat het peer-netwerk anders is dan
ensure the peer networks are different from=zorg ervoor dat de peer-netwerken anders zijn dan
Every 2 hours=Elke 2 uur
Every 3 hours=Elke 3 uur
Every 4 hours=Elke 4 uur
Every 6 hours=Elke 6 uur
Every 8 hours=Elke 8 uur
Every hour=Elk uur
Fahrenheit=Fahrenheit
Failed to open=Openen mislukt
Flash backup=Flash-back-up
Generate Key=Sleutel genereren
Generate Keypair=Sleutelpaar genereren
Header show description=Header tonen beschrijving
Import Tunnel=Tunnel importeren
In most cases, this should be your public WAN IPv4 instead=In de meeste gevallen zou dit het publieke WAN IPv4 moeten zijn
In most cases, this should be your public WAN IPv4=In de meeste gevallen moet dit het publieke WAN IPv4 zijn
In most cases, this should be your public WAN IPv6 instead=In de meeste gevallen zou dit het publieke WAN IPv6 moeten zijn
In most cases, this should be your public WAN IPv6=In de meeste gevallen moet dit het publieke WAN IPv6 zijn
inactive=inactief
Invalid data=Ongeldige data
IP address or FQDN=IP-adres of FQDN
IPv4 network=IPv4 netwerk
IPv6 network=IPv6 netwerk
is not in the=is niet in de
Join=Toetreden
LAN hub spoke access=LAN hub & spoke toegang
LAN to LAN access=LAN naar LAN toegang
Last handshake=Laatste handdruk
Leave=Vertrekken
Libvirt vdisk size=Libvirt vdisk grootte
List of peers=Peerlijst
Loading=Laden
Local endpoint=Lokaal eindpunt
Local gateway uses UPnP=Lokale gateway gebruikt UPnP
Local name=Lokale naam
Local private key=Lokale privésleutel
Local public key=Lokale publieke sleutel
Local server configuration=Lokale serverconfiguratie
Local server uses NAT=Lokale server gebruikt NAT
Local tunnel address IPv6=Lokaal tunneladres IPv6
Local tunnel address=Lokaal tunneladres
Local tunnel firewall=Lokale tunnelfirewall
Local tunnel network pool IPv6=Lokale tunnelnetwerkpool IPv6
Local tunnel network pool=Lokale tunnelnetwerkpool
MAC address mismatch=MAC adres komt niet overeen
mandatory=verplicht
More information=Meer informatie.
Mover is running=Mover is actief
MTU size=MTU grootte
name or ip address=naam of ip-adres
No Cache device present=Geen Cache apparaat aanwezig
no name=geen naam
No Reply=Geen antwoord
Not activated=Niet geactiveerd
not received=niet ontvangen
Not up-to-date=Niet uo-to-date
not used=niet gebruikt
Peer allowed IPs=Peer toegestane IP's
Peer DNS server=Peer DNS-server
Peer endpoint=Peer eindpunt
Peer name=Peernaam
Peer preshared key=Peer gedeelde sleutel
Peer private key=Peer privésleutel
Peer public key=Peer publieke sleutel
Peer tunnel address IPv6=Peer tunneladres IPv6
Peer tunnel address=Peer tunneladres
Peer type of access=Peer-type toegang
Peer update required=Peer update nodig
Persistent keepalive=Aanhoudend keepalive
Ping=Ping
Please consider re-applying all configurations=Overweeg om alle configuraties opnieuw toe te passen
Please note that the flash backup is not encrypted at this time=Houd er rekening mee dat de flash-back-up op dit moment niet is gecodeerd.
Please Reboot system to make new rules active=**Herstart** het systeem om nieuwe regels actief te maken
QEMU version=QEMU versie
Reinitialize=Herinitialiseren
Reinitializing=Herinitialiseren
Remark configure your router with port forwarding of port=pmerking: configureer uw router met port-forwarding van poort
Remark=LETOP
Remote access to LAN=Toegang op afstand tot LAN
Remote access to server=Toegang op afstand tot server
Remote peer configuration=Externe peer-configuratie
Remote tunneled access=Tunneltoegang op afstand
Replied=Beantwoord
Rule=Bestuur
Rules contain duplicate MAC address assignments=Regels bevatten dubbele MAC-adrestoewijzingen
Send crash information to Unraid developers=Stuur crashinformatie naar de Unraid-ontwikkelaars
Server hub spoke access=Server hub & spoke toegang
Server to server access=Server naar server toegang
Show Peer Config=Peer configuratie tonen
shutdown=Uitzetten
subnet=subnet
TCP=TCP
Test=Test
The Local endpoint does not resolve to an IPv4 address=Het lokale eindpunt wordt niet omgezet naar een IPv4-adres
The Local endpoint does not resolve to an IPv6 address=Het lokale eindpunt wordt niet omgezet naar een IPv6-adres
The Local endpoint resolves to=Het lokale eindpunt wordt omgezet naar
The Local tunnel network pool cannot be in=De lokale tunnelnetwerkpool kan niet voorkomen in
The Local tunnel network pool IPv6 cannot be in=De lokale tunnelnetwerkpool IPv6 kan niet voorkomen in
this must be the only peer in the tunnel and sole active tunnel when in use=dit moet de enige peer in de tunnel zijn en de enige actieve tunnel wanneer deze in gebruik is
This removes any connections running over this tunnel=Dit verwijdert alle verbindingen die over deze tunnel lopen
This Unraid Server was unreachable from the outside=Deze Unraid-server was van buitenaf onbereikbaar
to=naar
Toggle keys=Schakel sleutels
Toggle view=Schakelen tussen weergave
tunnel is inactive=tunnel is inactief
UDP=UDP
Unable to register this Unraid Server=Kan deze Unraid-server niet registreren
Unraidnet Status=Unraid.net Status
Updating=Bijwerken
UPnP forwarding not set=UPnP: forwarding niet gezet
UPnP state changed to=UPPnP toestand is veranderd naar
UPnP tunnel is inactive=UPnP: tunnel is inactief
Use image name dockerimg or docker-xfsimg or select a folder=Gebruik de afbeeldingsnaam docker.img of docker-xfs.img of selecteer een map
Use only letters A-Z, digits or space,dash,underscore=Gebruik enkel letters A-Z, cijfers of spatie,streepje,laag streepje
View Local Config=Lokale Configuratie tonen
View Peer Config=Peer Configuratie tonen
VM manager=VM manager
VPN tunneled access=VPN tunneltoegang
WAN Port=WAN poort
WireGuard Configuration=WireGuard configuratie
xfs vDisk=xfs vDisk
Your server has been registered=Uw server is geregistreerd
Your Unraid Server is reachable from the internet=Uw Unraid-server is bereikbaar via internet

; New entries (14) - 2021-05-08
%s ago=%s geleden
%s is out of range minimum 1 maximum 65535=%s is buitenbereik (minimum 1 maximum 65535)
DNS servers=DNS servers
Duplicate port entered=Dubbele port ingevoerd
Header custom meta text color=Menu aangepaste meta tekstkleur
Local syslog port=Lokale syslog poort
or=of
Port %s is already in use by other services=Poort %s is al in gebruik door andere diensten
Port %s is duplicated=Poort %s is dubbel
Port %s is out of range minimum 1 maximum 65535=Poort %s is buitenbereik (minimum 1 maximum 65535)
Port already in use=Poort is al in gebruik
Port out of range=Poort buitenbereik
Remote syslog port=Remote syslog poort
