Automatic theming=Automatisch thema
Bing API key=Bing API key
Bing=Bing
City name=Naam van de stad
Country name=Naam van het land
Day theme=Dag thema
Geocoding service=Geocoding service
Google API key=Google API key
Google=Google
MapQuest API key=MapQuest API key
MapQuest=MapQuest
Night theme=Nacht thema
No geographical coordinates found for the given address=Geen geografische coördinaten gevonden voor het opgegeven adres
Please adjust=Pas aan alstublieft
Postal code=Postcode
See=Zie
Street address=Straat
this site=deze site
to obtain a Bing API key=om een Bing API key te verkrijgen
to obtain a Google API key=om een Google API key te verkrijgen
to obtain a MapQuest API key=om een MapQuest API key te verkrijgen

:day_night_plug:
> Voer uw adresgegevens in (straat, stad, land) die worden gebruikt om de zonsopgangs- en zonsondergangstijden van uw locatie te berekenen.
>
> Een geocoderingsdienst wordt gebruikt om uw adres om te zetten naar geografische (lengte- en breedte-) coördinaten.<br>
> U moet zich registreren bij een van de beschikbare diensten en een unieke API key krijgen om van hun dienst gebruik te kunnen maken.
>
> Het **dag** thema wordt gekozen tussen zonsopgang en zonsondergang<br>
> Het **nacht** thema wordt gekozen tussen zonsondergang en zonsopgang
:end
